NO texture/wall/north.xpm
SO texture/wall/13.xpm
WE texture/wall/12.xpm
EA texture/wall/east.xpm
F 50,50,40
C 10,10,,70


        1111111111111111111111111
        1100000000110000001000001
        1010000011100000010000011
        1001000000000000000000001
111111111111000001110000000000001
100000000011000001110100111111111
10000000000000000000000000001
10000000000000000000000000001
10000001100000000000011000001
1000000110000000000011000001
10000000000000000000000000001
10000000000000000000000000001
10000000000000000000010000001
11110111110111011100010000001
11110111110111011101010010001
11000000110101011100010000001
100010000000000000000100S0001
10000000000000000000010000001
11000001110101111111111101111
11110111 11100000000000000011
11111111 11111111111111111111