NO ./path_to_the_north_texture
SO ./texture/ground.xpm
WE ./texture/wall.xpm
EA ./path_to_the_east_texture
F 220,100,0
C 255,30,0




111111111111111111111111111111
11111111100000000000000011111
100000000000000000111000100001
110000100000000000000000001111
10000111111100000000000111111
1111111000000000E0000000000001
11110000000000110000000000011
110000000000011110000000000011
100000000000111000000000000011
11000000000011100000000000111100
110000000001111000000000000111
11111111111111111111111111111111