NO ./path_to_the_north_texture
SO ./texture/ground.xpm
WE ./texture/wall.xpm
EA ./path_to_the_east_texture
F 220,100,0
C 255,30,0



1111111111111111111111111
1000011100110000000000001
101101 101110000N00000001
1111111111111111111111111