NO ./path_to_the_north_texture.xpm
SO ./texture/ground.xpm
WE ./texture/wall.xpm
EA ./path_to_the_east_texture.xpm
F 130,119,23
C 144,202,249



1111111111111111111111111
1000000000000000000000001
1000000000000000000000001
1000000000000000000000001
1000000000000000000000001
1000000000000000000000001
1000000000000000000000001
1000000000000000000000001
1000000000000000000000001
100000000000N000000000001
1000000000000000000000001
1000000000000000000000001
1000000000000000000000001
1000000000000000000000001
1000000000000000000000001
1000000000000000000000001
1000000000000000000000001
1000000000000000000000001
1111111111111111111111111