NO texture/wall/bricks.xpm
SO texture/wall/south.xpm
WE texture/wall/weast.xpm
EA texture/wall/east.xpm

F 25,22,2
C 10,10,50



1111111111111111111111111
1000000000000000000000001
1000000000000000000000001
10000000N0000000000000001
1000000000000001000000001
1000000000000010000000001
1000000000000000000000001
1000000000000000000000001
1000000000000000000000001
1000000000000000000000001
1000000000000000000000001
1000000000000000000000001
1000000000000000000000001
1000000000000000000000001
1000000000000000000000001
1000000000000000000000001
1000000000000000000000001
1000000000000000000000001
1111111111111111111111111