NO ./path_to_the_north_texture
SO ./texture/ground.xpm
WE ./texture/wall.xpm
EA ./path_to_the_east_texture
F 220,100,0
C 255,30,0



        1111111111111111111111111
        1000011100110000000000001
        101101 101110000000000001
        10001111000000000000000001
111111111010000001110000000000001
100000000010000001110111111111111
11110111111111011100000010001
11110111111111011101010010001
1100000011010101110000001E001
10000000000000001100000000001
10000000000000001101010010001
1100000111010101111101111000111
11110111 1110101 101111010001
11111111 1111111 111111111111
