NO ./path_to_the_north_texture.xpm
SO ./texture/ground.xpm
WE ./texture/wall.xpm
EA ./path_to_the_east_texture.xpm
F 130,119,23
C 144,202,249



        1111111111111111111111111
        1000011100110000000000001
        101101 1011100000000000011
        10001111000000000000000001
1111111110100000011100000000000011
100000000010000N01110111111111111
11110111111111011100000010001
11110111111111011101010010001
11000000110101011100000010001
10000000000000001100000000001
10000000000000001101010010001
1100000111010101111101111000111
11110111 1110101 101111010001
11111111 1111111 111111111111
