NO ./path_to_the_north_texture
SO ./texture/ground.xpm
WE ./texture/wall.xpm
EA ./path_to_the_east_texture
F 220,100,0
C 255,30,0


11111111                                                1             
10000001                                                11            
11111111                                                101           
                                                        10011         
              1111111  11111111111111111111             100001        
           1111100001  100011111000000001001            100001        
        1111100000001  100000011110111111101            1000001       
  1111111100000000001  10000000000011    101            10000001      
  1000000000000000001  10000000000111   11011111111     100000001     
  1100000000000000001  10000000000001   11000000001     1000000001    
  1111111111111111111  11111110111111   11111111101     11101100101  
                            10001               101     100000000001  
  11111111111111111     111110001111111111111   101111  1000000000001 
 111000000000000011    1100000000000000000001   100001  10000000000001
  10000000000000001    1000000000000000000001   1100011 10000000000001
  11000000100000011    1100111100000111110001   1000001 10000010000001
  1000000000000001      1000000000001   10001   1000001 1000000000001 
  11100000000000011111111000000000001   10001   11000011100000000001  
   1111000N00000000001000000000000001   10001  11100000000000000001   
   1100000000111001001000000001111111   11111  1000111111000000001    
   11111000001000100010100100000001            10001    100000001     
 111000000001000001000000000001111111111111111110001    10000001      
 111111000000000000000100100000000000000000000000001    1000001       
     11111100000000000000000011111111111111111000001    100001        
         1111110000111000111111            111111111    10001         
             11111111111111                             1001          
                                                        101           
                                                        11            
                                                        1