NO texture/wall/north.xpm
SO texture/wall/13.xpm
WE texture/wall/12.xpm
EA texture/wall/east.xpm
F 220,100,0
C 225,30,0


11111111111111111111111111111
10000000000000000000000000111
1000000000000000000N000000001
10000000000000000000000000111
10100000000000000000000000001
11111111111111111111111111111